................
. E   .    ... .
. . . .    ... .
. . .   ..  A. .
.   . .  ... . .
.              .
................
