███████████████████████████████████████████████████████████
█S  █ █ █      ███████     █ █   █ █  █████   █████  ████ █
█ █ █ █ ██  ████     █████ █ █ █ █ █      █               █
█ █   █    ██    ███    ██ █ █ █ █   █ █    ███  █████  █ █
█ █       █   ████  ███    █ █ █     █   ████      ██████ █
█ █ ████  █ █████  █  ████ █ █ █ █ █ █  ██    ██        █ █
█ █  █    █ █     ██     █ █   █ █ █ ██████████████████ █ █
█ █   █   █ █ █ ███████  █ ███████ ███                █ █ █
█ █████   █ █ █       █  █       █ █ █  █████ ███████ █ █ █
█          ██ █████   █████  █████ █ █              █ █ █ █
█ █████████ █     █      ███ ███ ███ ██████████████ █ █ █ █
█ █       ███████ ██████  ██     █            █   █ █ █ █ █
█ █ ████   █    █      █  ████ █ █ █ ███ ██████   █ █ █   █
█ █     █  █ █  ██████ █     █ █ █ █ ████████████ █ █ █ █ █
█   ███ █  █ █     █ █ █████ █ █ █ █ █          █ █ █ █ █ █
██████  █  █ █ █ █ █ █     █ █ █ █ █ █ ████████ ███ █ █ █ █
█       █  █         █████ █ █ █ █ █ █ █ ██  ██     █ █ █ █
█   █████ ████████ █  ██   █ █ █ █     █ ██  ████████ █ █ █
█     ██               █ █ █   █ █ █ █ █       █      █ █ █
█  ████ █  ███████████ █ █ █ ███ █ █ █ ██████  █ ██████ █ █
█  █      █          █ ███ █ █     █ █      █  █        █ █
█  █ ███ █████████   █     █ █   █ █ ██████ █ ██ ████ ███ █
█  █ █ █         █   ██ ████ █████████  ███ █ ██ █      █ █
█  █ █ █████████ █    █    █                █ ██ ████  ██ █
█  █ █     █   █ ██████    ██████████████████  █    █████ █
█  █ █████ ██  █                   ████   ███ █████    ██ █
█              ████  ███  ████   █                ████   Z█
███████████████████████████████████████████████████████████